##########
####..####
###....###
##......##
#........#
#....@...#
##......##
###....###
####..####
##########