###
#.#
#.#########
#.........#
#####..@..#
#####..#..#
###...##..#
..##.#....#
.##..######
.#.......##
.#.......##
.##########